****************
*E    *     *  *
*    *    *   *
*    *    *   *
*        *    *
*        *    *
*S            *
****************